%%%%%%%%%%%%%%%
%     %s%     %
%     % %     %
%             %
%             %
%             %
%             %
%             %
%      # #    %
%             %
%     t       %
%        #    %
%             %
%      b      %
%%%%%%%%%%%%%%%