%%%%%%%%%%%%%%%
%     % %     %
%     % %     %
%      s      %
%             %
%             %
%      %      %
%      %      %
%      # #    %
%             %
%             %
%        #    %
%        t    %
%b            %
%%%%%%%%%%%%%%%