%%%%%%%%%%%%%%%
      %s%     %
      % %     %
%             %
%             %
%             %
%      %      %
%      %      %
%      # #    %
%             %
%             %
%        #    %
%         t   %
%      b      %
%%%%%%%%%%%%%%%