%%%%%%%%%%%%%%%
%     % %     %
%     % %     %
%      s      %
%             %
%             %
%      %      %
%      %      %
%      ###    %
%             %
%             %
%        ##   %
%       #t    %
%b      #     %
%%%%%%%%%%%%%%%