%%%%%%%%%%%%%%%
%             %
%             %
%             %
%             %
%             %
%    %        %
%      %      %
%         %   %
%             %
%             %
%  %          %
%     %       %
%             %
%%%%%%%%%%%%%%%