%%%%%%%%%%%%%%%
%      s      %
% # # # # # # %
% # # #%# # # %
% # # # # # # %
% # #     # # %
%     # #     %
%% ##     ## %%
%     # #     %
% # # ### # # %
% # # # # # # %
% # #     # # %
% # # ### # # %
%    t#b#     %
%%%%%%%%%%%%%%%