################
#       #    s #
#       #      #
#   s   #      #
#       #      #
#       #      #
#           t  #
# b            #
####### ########
#       #      #
#   1   ##     #
#        #     #
#   ########   #
#              #
#              #
################