################
#              #
#              #
#              #
#              #
#              #
#              #
#              #
#       ########
#       #      #
#       ##     #
#        #     #
#        ###   #
#              #
#              #
################