################
#              #
#              #
#              #
#              #
#              #
#              #
#              #
####### ########
#       #      #
#       ##     #
#        #     #
#   ########   #
#              #
#              #
################