###############
#       #    s#
#   #         #
#   s         #
#       #     #
#     # #     #
#     #    #  #
#     #       #
## #### #######
#       #     #
#        # t  #
#        #    #
#   ########  #
#     s      b#
###############