################
#       #    s #
#   #          #
#   s          #
#       #      #
#     # #      #
#     #    #   #
#     #        #
## #### ########
#       #      #
#        # t   #
#        #     #
#   ########   #
#     s        #
#              #
################