################
#       #    s #
#       #      #
#   s          #
#       #      #
#     # #      #
#     #        #
#     #        #
####### ########
#       #      #
#       ##     #
#        #     #
#   ########   #
#     s        #
#              #
################