################
#   s #      t #
#   ###   #    #
##       #     #
###   #     #  #
##    #   ##   #
#              #
#  s    # #    #
# #### #########
# #            #
# ### # # #    #
# #         ####
#   #    #     #
#   #    #     #
##       #  s  #
################