###############
#   s #     t #
#    ##   #   #
##       #    #
###   #    b# #
##    #   ##  #
#             #
#  s    # #   #
# #### ###### #
# #           #
# ### # # #   #
# #         ###
#   #    #    #
##       #  s #
###############